1111111
100C001
1C0P011
1111001
1EC0011
1111111
