1111111111111111111111111111111111
1000000000000010000000000000000001
111P00010000011CCCCCCCCCCCCCCCCCC1
10011101000000100000000000C0000001
1001111E00000010000000000000000001
1001110100000010000000000000000001
10011100000000000000000000CC000001
1001000000000010000000000000000001
1001110000000010000000000000000001
1001110000000010000000000000000001
1000000000000010000000000000000001
1111111111111111111111111111111111
