1111111111111111111111111111111111
1000000000001111110000000000001111
1110000100000111100000000000000011
1P01110100000010000000000000000001
1001111000000010000000000000000001
10011101000000100000C00E0000000001
10C111000000000C000000000000000001
10010000000C0010000000000000000001
1001110000000010000000000000000001
1001110000000010111110C11111111001
1000000C00000011111111011111111101
1111111111111111111111111111111111
